9 16
################
#   #@  #    @ #
#    #@ @   #  #
#     #     #  #
#     #    ##@@#
#     @        #
#@####         #
# @@@#         #
################
